html = A
head = B
body = C
title = D
script = E
h1 = F
h2 = G
h3= H
h4 = I
h5 = J
h6 = K
p = L
em = M
button = N
b = O
abbr = P
strong = Q
small = R
div = S
a = T
form = U
table = V
tr = W
td = X
th = Y

VOID ELMT
link = a
br = b
hr = c
img = d
input = e

ATRIBUT WAJIB
rel = p
src = q




- Bikin nesting